11111111111111111111111111111111111111111111111111111111111111111111111111111111
1P0000000000000000000000000000000000000000000000000000000000000000000000000000E1
10000000000000000000000000000000000000000000000000000000000000000000000000000001
10000000000000000000000000000000000000000000000000000000000000000000000000000001
10000000110000000000000000000000000000000000000000000000000000000000000000000001
10000001111100000000000000000000000000000000000000000000000000000000000000000001
10000000111111000000000000000000000000000000000000000000000000000000000000000001
10000000001111111000000000000000000000000000000000000000000000000000000000000001
10000000000011111110000000000000000000000000000000000000000000000000000000000001
1000000000000C11111110000000000000000000000000C000000000000000000000000000000001
10000000000000000111111000000000000000000000000000000000000000000000000000000001
1000000000000000001111111100000000C000000000000000000000000000000000000000000001
1000000000000000000C011111110000000000000000000000000000000000000000000000000001
10000000000000000000000111111100000000000000000000000000000000000000000000000001
10000000000000000000000000111111000000000000000000000000000000000000000000000001
10000000000000000000000000011111111000000000000000000000000000000000000000000001
10000000000000000000000000000011111110000000000000000000000000000000000000000001
10000000000000000000000000000000111111100000000000000000000000000000000000000001
10000000000000000000000000000000001111111000000000000000000000000000000000000001
10000001110000000000000000000000000011111111000000000000000000000000000000000001
10000011111100000000000000000000000000011111100000000000000000000000000000000001
10000111111111100000000000000000000000000111111100000000000000000000000000000001
10000011111111110000000000000000000000000001111111000000000000000000000000000001
10000001111111111110000000000000000000000000011111100000000000000000000000000001
10000000001111111111110000000000000000000000000011000000000000000000000000000001
10000000000011111111111100000000000000000000000000000000000000000000000000000001
10000000000000011111111111000000000000000000000000000000000000000000000000000001
100000000000000C1111111111111000000000000000000000000000000000000000000000000001
100000000000000C0001111111111111000000000000000000000000000000000000000000000001
100000000000000C0000011111111111100000000000000000000000000000000000000000000001
1000000000000000000000C011111111111110000000000000000000000000000000000000000001
1000000000000000000000C00011111111111110000000000000000000C000000000000000000001
10000000000000000000000000000111111111111000000000000000000000000000000000000001
10000000000000000000000000000C01111111111110000000000000000000000000000000000001
10000000000000000000000000000C00011111111111110000000000000000000000000000000001
10000000000000000000000000000C00000011111111111110000000000000000C00000000000001
1000000000000000000000000000000000000C011111111111100000000000000000000000000001
10000000000000000000000000000000000000000111111111111000000000000000000000000001
10000000000000000000000000000000000000000001111111111111000000000000000000000001
10000000000000000000000000000000000000000000C01111111111110000000000000000000001
10000000000000000000000000000000000000000000000111111111111100000000000000000001
10000000000000000000000000000000000000000000000000011111111111100000000000000001
100000000000000000000000000000000000000000000000000C0111111111110000000000000001
10000000000000000000000000000000000000000000000000000000111111111000000000000001
10000000000000000000000000000000000000000000000000000000001111111100000000000001
10000000000000000000000000000000000000000000000000000000000011111000000000000001
10000000000000000000000000000000000000000000000000000000000000010000000000000001
10000000000000000000000000000000000000000000000000000000000000000000000000000001
10000000000000000000000000000000000000000000000000000000000000000000000000000001
10000000000000000000000000000000000000000000000000000000000000000000000000000001
10000000000000000000000000000000000000000000000000000000000000000000000000000001
11111111111111111111111111111111111111111111111111111111111111111111111111111111