1111111111111111111111111111111111111111
1P000C00000000000000000000000000C00000E1
1111111000111111100011111110001111111111
1000000010000000010000000001000000000001
10C0000010C00000010C000000010C0000000C01
1000000010000000010000000001000000000001
1111111000111111100011111110001111111111
1000000010000000010000000001000000000001
100C00001000C00001000C00000100C000000001
1000000010000000010000000001000000000001
1111111000111111100011111110001111111111
1000000010000000010000000001000000000001
10C0000010C00000010C000000010C0000000C01
1000000010000000010000000001000000000001
1111111000111111100011111110001111111111
1000000010000000010000000001000000000001
1000C0001000C00001000C00000100C000000001
1000000010000000010000000001000000000001
1111111000111111100011111110001111111111
1000000010000000010000000001000000000001
10C0000010C00000010C000000010C0000000C01
1000000010000000010000000001000000000001
1000000000000000000000000000000000000001
1111111111111111111111111111111111111111
