11111111111111111111111111111111111
10000000000000000000000000000000001
10000010001000000000000100010000001
10000001000100000000001000100000001
10000000100010000000010001000000001
10000000010001000000100010000000001
10000000100010000000010001000000001
10000001000100000000001000100000001
10000010001000000000000100010000001
10000000000000000000000000000000001
10000010001000000000000100010000001
10000001000100000000001000100000001
10000000100010000000010001000000001
10000000010001000000100010000000001
10000000100010000000010001000000001
10000001000100000000001000100000001
10000010001000000000000100010000001
10000000000000000000000000000000001
11111111111111111111111111111111111
