11111111111111111111111111111111
10000000000000000000000000000001
100C000000000000000000000000C001
10000011111100000001111110000001
10000000000000000000000000000001
100000000C000000000000C000000001
10000000000011111111000000000001
10000000000000000000000000000001
10000000000000000000000000000001
100000C000000000000000000C000001
10000000000000000000000000000001
1P00000000000000000000000000E001
10000000000000000000000000000001
11111111111111111111111111111111