111111111111111111111111111111111111
100000000000000000000000000000000001
100C00000000000000000000000000C00001
100001111110000000000001111110000001
100000000000000000000000000000000001
1000000000C000000000000C000000000001
100000000000111111111111000000000001
100000000000000000000000000000000001
100000000000000000000000000000000001
1000000C00000000000000000000C0000001
100000000000000000000000000000000001
100000000000000000000000000000000001
1P0000000000000000000000000000000E01
100000000000000000000000000000000001
111111111111111111111111111111111111