1111111111111111111111111111
1000000000000000000000000001
10000000000C0000000000000001
1000011111000000111110000001
1000000000000000000000000001
100000C000000000000C00000001
1000000000111111000000000001
1000000000000000000000000001
1P0000000000000000000000E001
1000000000000000000000000001
1000000C0000000000000C000001
1000000000000000000000000001
1111111111111111111111111111