11111111111111111111111111111111111
1P000000000000000000000000000000001
100000110011000000000C1100110000001
10000001100110000000011001100000001
10000000110011000000110011000000001
10000000011001100001100110000000001
10000000110011000000110011000000001
10000001100110C00000011001100000001
10000011001100000000001100110000001
1000000000000000C000000000000000001
100000110011000000000C1100110000001
10000001100110000000011001100000001
10000000110011000000110011000000001
10000000011001100001100110000000001
10000000110011000000110011000000001
10000001100110C00000011001100000001
10000011001100000000001100110000001
10000000000000000000000000000000001
1111111111111111E111111111111111111
