1111111111111111111111111111
1000000000000000000000000001
10000C000000C000000C00000001
1000000000000000000000000001
1000000000000000000000000001
10000C000000C000000C00000001
1000000000000000000000000001
1000000000000000000000000001
10000C000000C000000C00000001
1000000000000000000000000001
1000000000000000000000000001
10000C000000C000000C00000001
1000000000000000000000000001
1000000000000000000000000001
10000C000000C000000C00000001
1000000000000000000000000001
1000000000000000000000000001
10000000000E0000000000000001
1000000000000000000000000001
1000000000000000000000000001
1000000000000000000000000001
1000000000000000000000000001
1000000000000000000000000001
1000000000000000000000000001
1000000000000000000000000001
1000000000000000000000000001
1000000000000000000000000001
1000000000000000000000000001
1000000000000P0000000000001
1111111111111111111111111111