111111111111111111
100000000000000001
10C000C000000C0001
100000000000000001
100000000000000001
10C000C000000C0001
100000000000000001
10000000E000000001
100000000000000001
100000000000000001
10C000C000000C0001
100000000000000001
100000000000000001
10000000P000000001
111111111111111111