1111111111111111111111
1000000000000000000001
100C00000C000000C00001
1000000000000000000001
1000000000000000000001
100C00000C000000C00001
1000000000000000000001
100000000E0000000000001
1000000000000000000001
1000000000000000000001
100C00000C000000C00001
1000000000000000000001
1000000000000000000001
100000000P0000000000001
1111111111111111111111